0000000000000000000000000000440000000000
0000000000000000000000000000440000000000
0000000000000000000000000000000000000000
0000000000000000000000000000000000000000
2222222222222222222222222222222222000055
2222222222222222222222222222222222000055
0000000000000000000000000000000022000000
0000000000000000000000000000000022000000
0055000000004400000000000000000022000000
0055000000004400000000000000000022000000
0000000000000000000000000000000022000000
0000000000000000000000000000000022000000
0000000000222222222222222200000022000000
0000000000222222222222222200000022000000
0000000000220000000000002222222222000000
0000000000220000000000002222222222000000
0000000000220000000000000000000000000000
0000000000220000000000000000000000000000
0000005500220000005500000000000000000000
0000005500220000005500000000000000000000
0000000000220000000000000000004400000055
0000000000220000000000000000004400000055
4400000000220000000000000000000000000000
4400000000220000000000000000000000000000
0000000000222222222222222222222222222222
0000000000222222222222222222222222222222
0000000000000000000000000000000000000000
0000000000000000000000000000000000000000
5500000000000000000000000000000000000000
5500000000000000000000000000000000000000
0000000000000000000000000000000000000000
0000000000000000000000000000000000000000