0000000000000000000000000022000000000000
0000000000000000000000000022000000000000
0000000000000000000000000000000000000000
0000000000000000000000000000000000000000
1111111111111111111111111111111111000033
1111111111111111111111111111111111000033
0000000000000000000000000000000011000000
0000000000000000000000000000000011000000
0033000000002200000000000000000011000000
0033000000002200000000000000000011000000
0000000000000000000000000000000011000000
0000000000000000000000000000000011000000
0000000000111111111111111100000011000000
0000000000111111111111111100000011000000
0000000000110000000000001111111111000000
0000000000110000000000001111111111000000
0000000000110000000000000000000000000000
0000000000110000000000000000000000000000
0000003300110000003300000000000000000000
0000003300110000003300000000000000000000
0000000000110000000000000000002200000033
0000000000110000000000000000002200000033
2200000000110000000000000000000000000000
2200000000110000000000000000000000000000
0000000000111111111111111111111111111111
0000000000111111111111111111111111111111
0000000000000000000000000000000000000000
0000000000000000000000000000000000000000
3300000000000000000000000000000000000000
3300000000000000000000000000000000000000
0000000000000000000000000000000000000000
0000000000000000000000000000000000000000