00000000000000000000
00000000000000000000
22222222222222222000
00000000000000002000
00000000000000002000
00000000000000002000
00000222222220002000
00000200000022222000
00000200000000000000
00000200000000000000
00000200000000000000
00000200000000000000
00000222222222222222
00000000000000000000
00000000000000000000
00000000000000000000