00000000000002000000
00000000000000000000
11111111111111111003
00000000000000001000
03000020000000001000
00000000000000001000
00000111111110001000
00000100000011111000
00000100000000000000
00030100030000000000
00000100000000020003
20000100000000000000
00000111111111111111
00000000000000000000
30000000000000000000
00000000000000000000